'''''Animal Factory''''' est un film américain réalisé par 2000.

==Synopsis==
Ce film raconte l'histoire d'un jeune homme, Ron Decker, qui arrive dans la prison de San Quentin aux États-Unis. Il va se retrouver avec des co-détenus au lourd passé carcéral pour lesquels seule compte la loi du plus fort et sa survie dans ce milieu hostile dépendra uniquement des protections qu'il pourra obtenir auprès d'autres prisonniers.

Ce film dépeint de façon très réaliste un univers carcéral où règnent trafics en tout genre, violence et haine raciale.

==Fiche technique==
* Titre : ''Animal Factory''
* Réalisation : Steve Buscemi
* Scénario : Edward Bunker et John Steppling, d'après le roman d'Edward Bunker
* Production : Steve Buscemi, Elie Samaha, Julie Silverman, Andrew Stevens, Edward Bunker, Alan Cohen, Barry Cohen, Dale King, Jon Pearlman et Danny Trejo
* Musique : Jake La Botz et John Lurie
* Photographie : Phil Parmet
* Montage : Kate Williams
* Décors : Steve Rosenzweig
* Costumes : Lisa Parmet
* Pays d'origine : États-Unis
* Format : Couleurs - 1,78:1 - Dolby Digital - 35 mm
* Genre : Drame
* Durée : 94 minutes
* Dates de sortie : 24 janvier 2000 (festival de Sundance), 31 janvier 2001 (France)

==Distribution==
* Willem Dafoe : Earl Copen
* Edward Furlong : Ron Decker
* Danny Trejo : Vito
* Mark Boone Junior : Paul Adams
* Seymour Cassel : Lieutenant Seeman
* Mickey Rourke : Jan la travestie
* Tom Arnold : Buck Rowan
* John Heard : James Decker
* Chris Bauer : Bad Eye
* Rockets Redglare : Big Rand
* Jake La Botz : Jesse
* Mark Engelhardt : T.J.
* Edward Bunker : Buzzard
* Victor Pagan : Psycho Mike
* Ernest Harden Jr. : Richland
* Steve Buscemi : A.R. Hosspack

==Bande originale==
* ''This Ain't the Way I Come Up (But It's the Way I'm Going Down)'', interprété par Jake La Botz
* ''Rapture'', interprété par Antony Hegarty
* ''Demon'', interprété par Elizabeth Cook
* ''Lay Down the Bottle'', interprété par Jake La Botz
* ''I Hope I Never Get Too Old (To Rock N' Roll)'', interprété par Harry Dean Stanton
* ''Times Tables'', interprété par Illegibles
* ''Headset Zen'', interprété par Illegibles

{{Infobox Film |
  name         = Animal Factory |
  image        = Picture needed |
  writer       = Edward Bunker (novel and screenplay) and John Steppling |
  starring     = Tom Arnold<br>Seymour Cassel<br>J.C. Quinn<br>Steve Buscemi |
  director     = Steve Buscemi |
  producer     = Steve Buscemi<br>Julie Yorn|
  music        = John Lurie |
  editing      = Kate Williams |
  distributor  = Franchise Pictures |
  released     = October 22, 2000 |
  runtime      = 94 min. |
  language     = English |
  budget       = unknown | 
  imdb_id      = 0204137 |
}}

'''''Animal Factory''''' is a 2000.

Edward Furlong plays a young man named Ron Decker, who is sent to prison for drug possession, and Willem Dafoe is veteran con Earl Copen who takes Decker under his wing and introduces him into his own gang. Copen is the type of prisoner who has been behind bars long enough that, unlike most prisoners, he prefers his cell to society. Not only does Copen know how to survive behind bars, he knows how to thrive in the small society of prison convicts. Copen's knowledge of the legal system and the administrative side of the prison are shown as especially useful in this regard.

In the film ''Finding Nemo'' Dafoe - as a voice actor - played a virtually identical role only the prison in that film was an Aquarium.  ''Animal Factory'' was filmed on location at Holmesburg Prison in Philadelphia, Pennsylvania.  Filming was completed in 30 days, two days longer than originally scheduled. Director Steve Buscemi employed hundreds of prisoners from Curran-Fromhold Correctional Facility, the prison that replaced Holmesburg Prison in 1995.