Presentem una llista incompleta d'alguns dels '''problemes sense resoldre en física'''. Molts d'aquests problemes no són independents, estan relacionats entre sí, i la resposta a un d'ells segurament implicaria la resposta a altres. Alguns problemes són teòrics, és a dir, que les teories existents semblen incapaces d'explicar algun experimental. Altres són experimentals, és a dir, que hi ha una dificultat per crear un experiment per provar una teoria proposada, o per investigar un fenomen minuciosament, o bé que no hi ha evidències experimentals que confirmin (o desmenteixin) una teoria.

== Observacions sense explicació teòrica ==
* Els jets dels discos d'acreció: Per què els discos d'acreció de determinats objectes astronòmics (com els nuclis de galàxies actives) emeten jets relativistes en els seus eixos polars?
* L'acceleració de l'expansió de l'univers: Per què l'expansió de l'univers s'està accelerant? Són correctes les observacions que impliquen aquest fet? N'és responsable l'energia fosca?
* La teories quàntiques de camps? o per què no és zero per alguna raó de simetria encara desconeguda?
* La matèria fosca: Quina és la natura de la matèria fosca deduïda de les observacions?
* La rotació de les galàxies: Per què les parts exteriors de les galàxies roten a la mateixa velocitat que les internes? N'és responsable la matèria fosca?
* Els sòlids amorfs: Com és la transició entre una fase sòlida regular o fluida i una fase vítria? Quins processos físics donen lloc a les propietats generals dels vidres?
* L'asimetria bariònica: Per què hi ha moltíssima més matèria que antimatèria a l'univers?
* Constants físiques fonamentals: per què tenen els valors que tenen i no uns altres?
* Superconductivitat d'alta temperatura: Quin és el mecanisme físic que explica la superconductivitat d'alta temperatura? Per què no serveix la teoria BCS?
* La fletxa del temps: Per que l'univers tenia tan poca entropia inicialment? És això el què distingeix el passat del futur, que resulta en la segona llei de la termodinàmica?
* La turbulència: Quin és el model físic per descriure el comportament d'un fluid turbulent?
* L'Pioneer''?

== Teories proposades sense evidència experimental definitiva ==
* Inflació còsmica: És correcta la teoria del període inflacionari de l'univers? En cas afirmatiu, quins són els detalls d'aquesta època?
* Ones gravitatòries: Existeix la radiació gravitatòria predita per la relativitat general? N'hi ha al nostre univers procedent del Big Bang? o potser procedent de fonts astrofísiques? 
* Desintegració del protó: Quina és la vida mitjana del protó, si és que realment és inestable?
* Paràmetres del model estàndard: Per què les partícules tenen les masses que tenen? per què hi ha tres famílies de partícules? Existeix el bosó de Higgs que prediu el model?

== Problemes solucionats recentment ==
* El problema dels neutrins solars (2002), resolt gràcies a la identificació de l'oscil·lació dels tres tipus de neutrins (un tipus de neutrí pot transformar-se en un altre).
* Els esclats de raigs gamma de llarga durada (2003), associats a la mort d'estrelles massives en un tipus particular de supernova.

Os seguintes são alguns dos '''problemas não solucionados '''da''' teóricos, significando que as teorias existentes parecem incapazes de explicar alguns fenômenos observados ou resultados experimentais. Outros são experimentais, significando que há uma dificuldade em criar uma experiência para testar algumas teorias propostas ou para investigar alguns fenômenos com mais detalhes.

== Astrofísica e Cosmologia: ==

* Aceleração do Universo: Por que a expansão do universo é acelerada, como nós temos observado? Nossa compreensão do teorias quântica de campos, ou zero, como predito pela supersimetria? Qual será o destino final do universo?

* Inflação cósmica: A teoria da inflação cósmica está correta? Se estiver, quais são os detalhes desta época? Qual é o campo hipotético do inflaton que causa esta inflação?

* Buraco de verme ou buraco de minhoca: É possível construir um túnel no espaço-tempo a ligar dois pontos longínquos do universo?  

* Viagem no tempo: É possível?

* Explosões de raio gamma: Qual é a natureza destes objetos astronômicos extraordinariamente energéticos?

* Ondas gravitacionais: É possível construir um dispositivo que detecte as ondas gravitacionais?

* Paradoxo GZK: Por que alguns raios cósmicos parecem possuir as energias que são impossivelmente altas, dado que não há nenhuma fonte suficientemente energética de raios cósmicos perto da Terra, e os raios cósmicos emitidos por fontes distantes devem ter sido absorvidos pela radiação cósmica de fundo em microondas?

* massas aparente?

* Seta do tempo: Por que o universo tem uma entropia tão baixa no passado, resultando na distinção entre passado e futuro e a segunda lei da termodinâmica?

== Física de altas energias: ==

* Cromodinâmica quântica (QCD) no regime não-pertubativo: As equações da QCD permanencem insolúveis nas escalas da energia relevantes para descrever núcleos atômicos. Como é que a QCD obtem a física dos núcleos e os constituintes nucleares?

* Fusão nuclear: É possível construir um reator nuclear que obtenha energia pela fusão nuclear melhor que na fissão nuclear?

* Gravitação quântica: Como pode a teoria da mecânica quântica ser fundida com a teoria da relatividade geral para produzir uma "teoria do tudo"? Nossa compreensão atual da força gravitacional permanece correta em escalas microscópicas de comprimento? Que predições verificáveis algumas teorias da gravitação quântica fazem?

* Supersimetria: A supersimetria é uma simetria da natureza? Se for, como a supersimetria é quebrada, e por quê?