'''''Après la pluie''''' (''Ame Agaru'', 雨　あがる) est un film japonais réalisé en 1999 par Takashi Koizumi d'après un scénario écrit par Akira Kurosawa.

== Synopsis ==
L'histoire se déroule dans le Japon du . Alors qu'une terrible tempête fait déborder la rivière, de nombreux voyageurs sont bloqués dans une auberge isolée. Parmi ces voyageurs se trouve un samourai sans maître (ronin) du nom d'Ihei Misawa, accompagné de sa femme Tayo. Lorsque la pluie cesse, Ihei, qui excelle dans l'art du sabre (iaijutsu et kenjutsu) décide de participer à des duels primés, afin de gagner de l'argent et de la nourriture.

En empêchant un duel inutile, Ihei est remarqué par le daimyo Nagai Izuminokami Shigeaki, qui lui propose de devenir le maître d'armes de son fief. Mais le parcours est semé d'embûches, et son passé le rattrape peu à peu.

==Fiche technique==
* Titre : ''Après la pluie''
* Titre original : 雨　あがる (''Ame Agaru'')
* Réalisation : Takashi Koizumi
* Mise en scène : Takashi Koizumi
* Scénario : Akira Kurosawa et Shugoro Yamamoto 
* Production : Hisao Kurosawa , Hara Masato
* Sociétés de production : Kurosawa Production
* Musique : Masaru Satô 
* Photographie : Masaharu Ueda
* Décors : Yoshiro Muraki
* Costumes : Kasuko Kurosawa
* Montage : Hideto Aga
* Pays d'origine : Japon
* Genre : Samourai, Chambara
* Durée : 92 minutes
* Date de sortie : 1999 (Japon)

{{Film infobox |
  tytuł_filmu    = Po deszczu|
  image = |
  imdb_id        = 0181960 |
  oryginalny_tytuł = 雨あがる |
  gatunek_filmu  = dramat, obyczajowy |
  kraj_produkcji =  <br />  |
  czas_trwania   = 91 min |
  data_premiery  =  6 września 1999 <br /> 27 października 2000 |
  reżyseria      = Takashi Koizumi, |
  scenariusz     = Akira Kurosawa |
  role           = Akira Terao,<br /> Yoshiko Miyazaki,<br /> Shiro Mifune,<br /> Mieko Harada,<br /> Fumi Dan |
  muzyka         = Masaru Satô |
  zdjęcia        = Masaharu Ueda |
  produkcja      = Masato Hara,<br /> Hisao Kurosawa,<br /> Tsutomu Sakurai,<br /> Kayo Yoshida |
  nagrody        = |
  dystrybucja    = |
  od_lat         = |
  scenografia    = Yoshirô Muraki,<br /> Hideto Aga |
  montaż         = Hideto Aga |
  budżet         = |
  język          = japoński |
  kostiumy       = Kazuko Kurosawa |
}}
'''''Ame agaru''''' (jap. 雨あがる; pol. ''Po deszczu'') – japońsko-francuski film, który powstał na podstawie opowiadania Shuguro Yamamoto. Na ekranach kin zadebiutował w roku 1999, zaś polska premiera odbyła się 27 października 2000. Film trwa 92 minuty.

Akira Kurosawa jest autorem scenariusza do tego filmu. Miał zamiar również go wyreżyserować. Był już gotowy scenopis, dekoracje i kostiumy, niestety jego niespodziewana śmierć (6 września 1998 roku) zatrzymała dalsze prace nad filmem. Dzieło dokończył wieloletni asystent reżysera Takashi Koizumi. Starał się on dochować wierności cechom twórczości swojego mistrza. Zdecydował się zrezygnować z ekspresyjnego sposobu opowiadania, na rzecz spokojnej i klarownej narracji.

== Twórcy filmu ==
* Scenariusz: Akira Kurosawa, Shugoro Yamamoto
* Reżyseria: Takashi Koizumi
* Zdjęcia: Masaharu Ueda
* Scenografia: Yoshiro Muraki
* Kostiumy: Kazuko Kurosawa
* Montaż: Hideo Aga
* Muzyka: Masaru Sato
* Produkcja: Masato Hara. Hisao Kurosawa
* Operator: Shoji Ueda
* Asystent Operatora: Takao Saito
* Dyrektor Artystyczny: Yoshiro Muraki
* Nadzór Artystyczny: Teruyo Mogami

== Obsada ==
* Akira Terao: Ihei Misawa
* Yoshiko Miyazaki: Tayo Misawa
* Shiro Mifune: Lord Shigeaki
* Mieko Harada: Okin
* Fumi Dan: Okugata
* Hisashi Igawa: Ishiyama Kihei
* Hidetaka Yoshioka: Sakakibara Gonnojo
* Tatsuya Nakadai: Gettan Tsuji
* Tatsuo Tatsumura: Sekkyo-Bushi Jii (starzec)
* Takayuki Katô: Hayato Naito